001122330011221
001122001122001
112200330011223
001122001122001
----333-----33
010101020202020
121212121212000
000111122200002
001122001100220

