Balls:
>500,606,-4.94975,-4.94975,1,7
Bricks:
>012112312031
>302020321030
>101013022000
>320200020001
>221012223223
>112331212331
>130200320222
>301132111022
Bat:
>115
Game: