Balls:
>478.357,308.156,-4.02492,-8.04984,0,9
Bricks:
>-1111111111111-
>00-----------00
>11-----------11
>000-00300000000
>11-----------11
>00-----------00
>10-----------11
>00-----------00

Bat:
>115,700,630
Game:
>3,4